S00100000000000
010011011110110
001000010001010
100111000101000
001000000100111
010010111001000
000010000100010
001100001011110
010010010000000
001010100111111
100010101000000
010100101001110
000001101010000
011110101010111
00000010001000E
